prim_key	prim_key
r1agey	age
ragender	sex
raedyrs	educyrs
h1rural	rurality
r1location	hospitalised
r1wtresp	weight_base
r1obsnoise	env_noise
r1obsodor	env_odor
r1obsair	env_air
r1obshouse	env_house
r1borient	orientation
r1bexefu	executive_function
r1blangf	lang_fluency
r1bmemory	memory
r1bvsp	visuospatial
r1nmemimm	memory_immediate_episodic
r1nmemdel	memory_delayed_episodic
r1nmemrec	memory_recognition
r1nreason	abstract_reasoning
r1natnspd	attention_speed
r1sgcp	general_cognition_score
r1hmse_scorz	hmse_score
r1word_totaz	word_list_learning_immediate
r1word_dz	list_learning_delayed
r1wre_scorez	word_list_recognition
r1log_recoz	logical_memory_recognition
r1bm_immexz	logical_memory_immediate
r1bm_reclexz	logical_memory_delayed
r1verbalz	verbal_fluency
r1csid_scorz	csid_score
r1rv_scorez	ravens_test
r1cog_totalz	total_std_cog_score
r1i_hear	hearing_seeing_any_diff
r1i_sleep	sleep_lastnight
r1systo	systolic_avg
r1diasto	diastolic_avg
r1pulse	pulse
r1bphigh	high_blood_pressure
r1mheight	height_m
r1mweight	weight_kg
r1mbmi	BMI
r1bmicat	BMI_category
r1adla_d	total_adl_difficult
r1iadltot1_d	total_iadl_difficult
r1cesd10	CESD_poor_mental_health
r1anx5	anxiety
r1mna_scale	nutrition_assessment
r1spice	total_spice_eaten
r1hear_r	hearing_right_ear
r1hear_l	hearing_left_ear
r1hear_aid	hearing_wear_aids
r1prs_toplam	PRS_lambert
r1prs_topkun	PRS_kunkle
r1prs_topjan	PRS_jansen
r1prs_topcog	PRS_davies
r1prs_pc1	gen_PCA1
r1prs_pc2	gen_PCA2
r1prs_pc3	gen_PCA3
r1prs_pc4	gen_PCA4
r1prs_pc5	gen_PCA5
r1rs7412	PRS_rs7412
r1rs429358	PRS_rs429358
r1cdr_final	consensus_score_final
r1cdr_incon	consensus_inconsistencies